ID,Major,Year,M_GPA,F_GPA,COMBINED_GPA,M_EN,F_EN,C_EN
1231,CS and/or Eng Multiple Majors (data submitted in aggregation),2005,3.43,3.42,3.4280000000000004,88,22,110
1232,CS and/or Eng Multiple Majors (data submitted in aggregation),2006,3.43,3.42,3.4277319587628865,75,22,97
1233,CS and/or Eng Multiple Majors (data submitted in aggregation),2007,3.43,3.43,3.43,55,16,71
1236,CS and/or Eng Multiple Majors (data submitted in aggregation),2010,3.44,3.65,3.488461538461539,30,9,39
1237,CS and/or Eng Multiple Majors (data submitted in aggregation),2011,3.41,3.4,3.407435897435897,29,10,39
4181,CS and/or Eng Multiple Majors (data submitted in aggregation),2014,3.18,3.27,3.195780821917808,1806,384,2190
4182,CS and/or Eng Multiple Majors (data submitted in aggregation),2013,3.1,3.21,3.1189635710620833,1613,336,1949
4183,CS and/or Eng Multiple Majors (data submitted in aggregation),2012,3.07,3.18,3.089661835748792,1360,296,1656
4184,CS and/or Eng Multiple Majors (data submitted in aggregation),2011,3.05,3.13,3.064285714285714,989,215,1204
4185,CS and/or Eng Multiple Majors (data submitted in aggregation),2010,3.01,3.03,3.0133679833679836,800,162,962
4186,CS and/or Eng Multiple Majors (data submitted in aggregation),2009,2.96,3.09,2.9824650571791613,651,136,787
4187,CS and/or Eng Multiple Majors (data submitted in aggregation),2008,2.94,3.03,2.953401253918495,543,95,638
4188,CS and/or Eng Multiple Majors (data submitted in aggregation),2007,2.98,2.98,2.98,521,81,602
4189,CS and/or Eng Multiple Majors (data submitted in aggregation),2006,2.93,2.99,2.93859649122807,586,98,684
4190,CS and/or Eng Multiple Majors (data submitted in aggregation),2005,3.0,2.93,2.990618556701031,672,104,776
4191,CS and/or Eng Multiple Majors (data submitted in aggregation),2004,3.0,3.08,3.011332633788038,818,135,953
4192,CS and/or Eng Multiple Majors (data submitted in aggregation),2003,3.03,3.03,3.03,903,184,1087
4242,CS and/or Eng Multiple Majors (data submitted in aggregation),2012,3.13,3.28,3.1821739130434783,15,8,23
4243,CS and/or Eng Multiple Majors (data submitted in aggregation),2013,3.27,3.31,3.2823076923076924,36,16,52
4267,CS and/or Eng Multiple Majors (data submitted in aggregation),2013,2.85,2.72,2.8291796875,215,41,256
4268,CS and/or Eng Multiple Majors (data submitted in aggregation),2012,2.81,2.69,2.788938775510204,202,43,245
4269,CS and/or Eng Multiple Majors (data submitted in aggregation),2011,2.71,2.8,2.728,200,50,250
4270,CS and/or Eng Multiple Majors (data submitted in aggregation),2010,2.71,2.66,2.7003141361256544,154,37,191
4271,CS and/or Eng Multiple Majors (data submitted in aggregation),2009,2.88,2.73,2.8532758620689656,143,31,174
4370,CS and/or Eng Multiple Majors (data submitted in aggregation),2003,2.92,2.96,2.9265810397553516,1366,269,1635
4371,CS and/or Eng Multiple Majors (data submitted in aggregation),2004,2.94,2.93,2.938671222475323,1142,175,1317
4372,CS and/or Eng Multiple Majors (data submitted in aggregation),2005,2.93,2.93,2.93,884,120,1004
4373,CS and/or Eng Multiple Majors (data submitted in aggregation),2006,2.91,2.95,2.9146063454759106,753,98,851
4374,CS and/or Eng Multiple Majors (data submitted in aggregation),2007,2.99,2.96,2.9860921052631584,661,99,760
4375,CS and/or Eng Multiple Majors (data submitted in aggregation),2008,3.04,2.97,3.0293080939947776,649,117,766
4376,CS and/or Eng Multiple Majors (data submitted in aggregation),2009,3.02,3.03,3.0217076326002585,641,132,773
4377,CS and/or Eng Multiple Majors (data submitted in aggregation),2010,3.0,3.01,3.001888198757764,653,152,805
4378,CS and/or Eng Multiple Majors (data submitted in aggregation),2011,3.08,3.03,3.069936775553214,758,191,949
4379,CS and/or Eng Multiple Majors (data submitted in aggregation),2012,3.06,3.03,3.053304721030043,905,260,1165
4380,CS and/or Eng Multiple Majors (data submitted in aggregation),2013,3.03,3.03,3.0299999999999994,1260,386,1646
4381,CS and/or Eng Multiple Majors (data submitted in aggregation),2014,3.06,3.07,3.062295399515738,1591,474,2065
4382,CS and/or Eng Multiple Majors (data submitted in aggregation),2015,3.12,3.18,3.134559585492228,1754,562,2316
4386,CS and/or Eng Multiple Majors (data submitted in aggregation),2014,3.05,3.27,3.070268006700167,542,55,597
4598,CS and/or Eng Multiple Majors (data submitted in aggregation),2009,2.87,3.08,2.8964766839378235,506,73,579
4599,CS and/or Eng Multiple Majors (data submitted in aggregation),2010,2.89,3.12,2.917138643067847,598,80,678
4600,CS and/or Eng Multiple Majors (data submitted in aggregation),2011,2.9,2.89,2.8988303341902313,687,91,778
4601,CS and/or Eng Multiple Majors (data submitted in aggregation),2012,2.95,3.08,2.9650235849056608,750,98,848
4602,CS and/or Eng Multiple Majors (data submitted in aggregation),2013,2.81,3.03,2.8356196581196578,827,109,936
4603,CS and/or Eng Multiple Majors (data submitted in aggregation),2014,2.89,3.1,2.91408,664,86,750
4681,CS and/or Eng Multiple Majors (data submitted in aggregation),2014,2.9,2.8,2.8795918367346935,78,20,98
4881,CS and/or Eng Multiple Majors (data submitted in aggregation),2015,2.94,3.08,2.9582890173410403,752,113,865
4903,CS and/or Eng Multiple Majors (data submitted in aggregation),2016,3.49,3.43,3.479545793000745,1109,234,1343
4943,CS and/or Eng Multiple Majors (data submitted in aggregation),2014,2.87,2.89,2.873286384976526,178,35,213
4944,CS and/or Eng Multiple Majors (data submitted in aggregation),2015,2.93,2.64,2.878174904942966,216,47,263
5271,CS and/or Eng Multiple Majors (data submitted in aggregation),2010,2.29,2.58,2.3922435897435896,101,55,156
5272,CS and/or Eng Multiple Majors (data submitted in aggregation),2011,2.37,2.36,2.36671875,129,63,192
5273,CS and/or Eng Multiple Majors (data submitted in aggregation),2012,2.49,2.47,2.4840625000000003,135,57,192
5274,CS and/or Eng Multiple Majors (data submitted in aggregation),2013,2.45,2.49,2.460146341463415,153,52,205
5275,CS and/or Eng Multiple Majors (data submitted in aggregation),2014,2.52,2.56,2.529655172413793,154,49,203
5276,CS and/or Eng Multiple Majors (data submitted in aggregation),2015,2.53,2.68,2.572142857142857,151,59,210
1255,Information Technology,2009,2.87,2.88,2.8717336683417085,658,138,796
1256,Information Technology,2010,2.9,3.01,2.9209049773755655,716,168,884
1257,Information Technology,2011,2.94,3.02,2.9550511247443763,794,184,978
1258,Information Technology,2012,2.71,2.75,2.71734375,836,188,1024
1392,Information Technology,2004,3.07,3.14,3.077760532150776,802,100,902
1393,Information Technology,2005,2.01,3.04,2.1169615384615383,699,81,780
1394,Information Technology,2006,3.02,3.04,3.0220782726045887,664,77,741
1395,Information Technology,2007,2.95,3.01,2.9566492829204694,682,85,767
1700,Information Technology,2008,2.93,2.67,2.9025555555555558,161,19,180
1701,Information Technology,2009,2.98,2.89,2.9734677419354836,230,18,248
1702,Information Technology,2010,2.88,3.19,2.9097864768683275,254,27,281
1703,Information Technology,2011,2.88,2.85,2.8774015748031494,348,33,381
1704,Information Technology,2012,2.9,3.04,2.914909090909091,344,41,385
1705,Information Technology,2013,2.88,3.21,2.9184085510688833,372,49,421
1979,Information Technology,2013,2.99,2.38,2.931904761904762,38,4,42
1980,Information Technology,2013,2.59,2.79,2.6376190476190478,32,10,42
2010,Information Technology,2013,2.7,2.85,2.7290830945558744,844,203,1047
4170,Information Technology,2014,2.88,3.07,2.9078666666666666,384,66,450
4228,Information Technology,2010,2.15,3.13,2.2531578947368422,85,10,95
4229,Information Technology,2011,2.9,1.75,2.692168674698795,68,15,83
4230,Information Technology,2012,2.63,3.07,2.677142857142857,75,9,84
4231,Information Technology,2013,2.3,2.5,2.3285714285714287,60,10,70
4670,Information Technology,2015,2.95,3.11,2.9752477064220186,459,86,545
4671,Information Technology,2014,2.96,3.15,2.9881330472103,397,69,466
4672,Information Technology,2013,2.92,3.06,2.938064516129032,351,52,403
4674,Information Technology,2012,2.92,2.98,2.926814404432133,320,41,361
4676,Information Technology,2011,2.95,3.07,2.961178082191781,331,34,365
4677,Information Technology,2010,2.9,3.21,2.925898734177215,362,33,395
4678,Information Technology,2009,2.9,3.27,2.9324711316397227,395,38,433
4679,Information Technology,2008,2.88,3.1,2.8936283185840703,424,28,452
5218,Information Technology,2014,2.2,3.04,2.3251063829787233,80,14,94
5219,Information Technology,2015,2.21,2.58,2.268267716535433,107,20,127
5281,Information Technology,2016,3.02,3.24,3.058228279386712,485,102,587
5297,Information Technology,2011,2.79,2.93,2.809111111111111,272,43,315
5298,Information Technology,2012,2.7,2.86,2.7243478260869565,273,49,322
5299,Information Technology,2013,2.75,2.99,2.791359223300971,341,71,412
5300,Information Technology,2014,2.77,2.93,2.7960869565217394,385,75,460
5301,Information Technology,2015,2.73,3.16,2.7950420168067227,404,72,476
1282,Informatics,2005,3.0,3.0,3.0,239,36,275
1283,Informatics,2006,3.0,3.1,3.0144444444444445,231,39,270
2103,Informatics,2014,3.15,3.34,3.1953982300884953,688,216,904
4781,Informatics,2015,3.16,3.13,3.1538235294117647,162,42,204
4782,Informatics,2014,2.98,3.26,3.036,16,4,20
1458,Computer Science + X,2004,3.0,2.8,2.9627906976744187,35,8,43
1459,Computer Science + X,2005,2.7,3.7,2.8351351351351353,32,5,37
1461,Computer Science + X,2007,3.06,3.81,3.137586206896552,26,3,29
2312,Computer Science + X,2011,3.0,3.35,3.050689655172414,124,21,145
2543,Computer Science + X,2011,2.97,3.08,3.0081549815498154,177,94,271
4406,Computer Science + X,2012,2.98,3.16,3.0536032388663967,146,101,247
4407,Computer Science + X,2013,2.97,3.09,3.0229870129870133,129,102,231
4408,Computer Science + X,2014,2.97,3.16,3.055890410958904,120,99,219
4409,Computer Science + X,2015,3.03,3.15,3.0865022421524664,118,105,223
4617,Computer Science + X,2010,3.52,3.29,3.4851184834123226,179,32,211
4618,Computer Science + X,2011,3.32,3.39,3.334,192,48,240
4619,Computer Science + X,2012,3.52,3.38,3.489038461538461,243,69,312
4620,Computer Science + X,2013,3.54,3.54,3.54,369,121,490
4621,Computer Science + X,2014,3.43,3.55,3.4605806451612904,462,158,620
4909,Computer Science + X,2011,3.13,3.2,3.1533333333333338,12,6,18
4910,Computer Science + X,2012,3.11,3.1,3.107307692307692,19,7,26
4911,Computer Science + X,2013,2.95,2.96,2.9520000000000004,32,8,40
4912,Computer Science + X,2014,3.08,3.28,3.116923076923077,53,12,65
4913,Computer Science + X,2015,3.28,3.34,3.2929310344827583,91,25,116
4914,Computer Science + X,2011,2.98,3.43,3.0403658536585367,71,11,82
4915,Computer Science + X,2012,3.06,3.44,3.14,75,20,95
4916,Computer Science + X,2013,3.11,3.22,3.130584795321637,139,32,171
4917,Computer Science + X,2014,3.22,3.32,3.237391304347826,190,40,230
4918,Computer Science + X,2015,3.21,3.21,3.21,226,52,278
4920,Computer Science + X,2014,2.93,3.31,3.082,6,4,10
4921,Computer Science + X,2015,3.0,3.15,3.0375,9,3,12
4923,Computer Science + X,2014,2.88,3.98,3.1244444444444444,7,2,9
4924,Computer Science + X,2015,2.94,2.91,2.933333333333333,14,4,18
4926,Computer Science + X,2014,3.16,3.2,3.1755555555555564,11,7,18
4927,Computer Science + X,2015,3.19,2.46,2.955357142857143,19,9,28
4928,Computer Science + X,2014,3.32,3.33,3.3229999999999995,7,3,10
4929,Computer Science + X,2015,3.16,3.28,3.198823529411765,23,11,34
4937,Computer Science + X,2016,3.01,3.16,3.0864285714285713,103,107,210
5267,Computer Science + X,2013,3.08,3.26,3.115840707964602,181,45,226
5268,Computer Science + X,2014,2.84,3.16,2.9125773195876286,225,66,291
5269,Computer Science + X,2015,2.94,3.0,2.954254143646409,276,86,362
1462,Information Science,2004,2.5,2.8,2.5640243902439024,129,35,164
1463,Information Science,2005,2.6,2.9,2.650675675675676,123,25,148
1465,Information Science,2007,2.8,3.2,2.8925619834710745,93,28,121
3330,Information Science,2008,2.83,2.9,2.846578947368421,116,36,152
3331,Information Science,2009,2.79,2.79,2.79,136,32,168
3332,Information Science,2010,2.8,2.91,2.82231884057971,165,42,207
3333,Information Science,2011,2.86,3.09,2.902112676056338,174,39,213
4604,Information Science,2010,3.35,3.35,3.35,30,7,37
4605,Information Science,2011,3.37,3.52,3.3840625,29,3,32
4606,Information Science,2012,3.17,3.21,3.18,27,9,36
4607,Information Science,2013,3.24,3.29,3.258867924528302,33,20,53
4608,Information Science,2014,3.22,3.27,3.237605633802817,46,25,71
4622,Information Science,2010,3.08,3.3,3.149259259259259,37,17,54
4623,Information Science,2011,3.05,3.22,3.11375,40,24,64
4624,Information Science,2012,3.15,3.44,3.29046875,33,31,64
4625,Information Science,2013,3.0,3.39,3.2028000000000003,36,39,75
4626,Information Science,2014,3.04,3.32,3.1952475247524754,45,56,101
4783,Information Science,2013,2.91,3.05,2.9334449760765553,174,35,209
4784,Information Science,2012,2.85,3.2,2.92,160,40,200
4785,Information Science,2014,2.89,2.94,2.8998076923076925,209,51,260
4786,Information Science,2015,2.82,3.46,2.9232258064516126,78,15,93
5340,Information Science,2013,2.9,3.1,2.9287292817679558,310,52,362
5341,Information Science,2014,2.93,3.11,2.9554867256637167,291,48,339
5342,Information Science,2015,2.91,3.01,2.926568047337278,282,56,338
5343,Information Science,2016,2.89,2.92,2.8956962025316453,256,60,316
1554,Computer Information Systems,2008,2.84,3.0,2.8675862068965516,144,30,174
1555,Computer Information Systems,2009,2.81,2.8,2.8081538461538464,159,36,195
1556,Computer Information Systems,2010,2.75,2.81,2.758974358974359,199,35,234
1557,Computer Information Systems,2011,2.79,2.92,2.817344827586207,229,61,290
1558,Computer Information Systems,2012,2.83,2.95,2.851735849056604,217,48,265
4481,Computer Information Systems,2014,2.51,3.04,2.606951219512195,67,15,82
1324,Computer Science,2008,3.1,3.2,3.107235142118863,359,28,387
1325,Computer Science,2009,3.1,3.2,3.107901234567901,373,32,405
1326,Computer Science,2010,3.1,3.3,3.119047619047619,380,40,420
1327,Computer Science,2011,3.1,3.3,3.123144104803494,405,53,458
1340,Computer Science,2004,2.5,2.7,2.5718367346938775,157,88,245
1341,Computer Science,2005,2.5,2.7,2.570967741935484,120,66,186
1388,Computer Science,2004,3.03,3.18,3.03893470790378,821,52,873
1389,Computer Science,2005,2.99,3.22,3.0012469437652816,778,40,818
1390,Computer Science,2006,2.99,3.34,3.0059731543624166,711,34,745
1391,Computer Science,2007,2.96,3.13,2.969914651493599,662,41,703
1400,Computer Science,2004,2.95,3.26,2.9660806916426514,329,18,347
1401,Computer Science,2005,2.99,3.27,3.0065680473372782,318,20,338
1430,Computer Science,2003,2.52,3.03,2.5676978417266185,252,26,278
1431,Computer Science,2004,2.84,2.87,2.8422173913043474,213,17,230
1432,Computer Science,2005,2.64,2.48,2.6310000000000002,151,9,160
1433,Computer Science,2006,2.87,3.29,2.895648854961832,123,8,131
1434,Computer Science,2007,2.8,2.89,2.8080689655172413,132,13,145
1435,Computer Science,2008,2.82,3.1,2.8461870503597124,126,13,139
1436,Computer Science,2009,2.92,3.16,2.942677165354331,115,12,127
1437,Computer Science,2010,2.81,3.17,2.8502797202797203,127,16,143
1438,Computer Science,2011,2.82,3.14,2.8529696969696965,148,17,165
1439,Computer Science,2012,3.2,3.4,3.221590909090909,157,19,176
1479,Computer Science,2008,3.0,3.05,3.004911838790932,358,39,397
1489,Computer Science,2009,2.93,3.17,2.955427509293681,481,57,538
1490,Computer Science,2010,2.9,3.25,2.944657097288676,547,80,627
1491,Computer Science,2011,2.88,3.26,2.925862068965517,561,77,638
1492,Computer Science,2012,2.84,3.29,2.8991463414634144,641,97,738
1521,Computer Science,2008,2.8,2.8,2.8,305,55,360
1522,Computer Science,2009,2.72,2.75,2.7244097995545657,383,66,449
1523,Computer Science,2010,2.79,2.94,2.8119026548672568,386,66,452
1524,Computer Science,2011,2.77,2.84,2.7787837837837834,453,65,518
1525,Computer Science,2012,2.83,2.86,2.833712871287129,531,75,606
1570,Computer Science,2009,3.38,3.35,3.3731067961165047,238,71,309
1571,Computer Science,2010,3.42,3.38,3.4100662251655636,227,75,302
1618,Computer Science,2004,2.6,2.5,2.5921739130434784,318,27,345
1619,Computer Science,2005,2.5,2.5,2.5,272,21,293
1620,Computer Science,2006,2.5,2.75,2.5137614678899083,309,18,327
1625,Computer Science,2004,2.9,3.0,2.9129943502824855,154,23,177
1626,Computer Science,2005,3.0,3.0,3.0,137,27,164
1627,Computer Science,2006,2.95,3.0,2.9592592592592593,132,30,162
1630,Computer Science,2010,2.98,2.88,2.964259259259259,273,51,324
1685,Computer Science,2012,3.07,3.06,3.0687608069164263,608,86,694
1686,Computer Science,2011,2.92,3.02,2.930931899641577,497,61,558
1688,Computer Science,2010,2.98,2.98,2.98,476,58,534
1689,Computer Science,2009,2.99,3.03,2.9942710472279264,435,52,487
1694,Computer Science,2008,3.03,3.15,3.0416556291390724,409,44,453
1695,Computer Science,2009,3.04,3.23,3.059525691699605,454,52,506
1696,Computer Science,2010,3.07,3.2,3.0827450980392155,506,55,561
1697,Computer Science,2011,3.06,3.15,3.0668031496062995,587,48,635
1698,Computer Science,2012,3.08,3.25,3.096102841677943,669,70,739
1699,Computer Science,2013,3.01,3.21,3.0280737217598093,765,76,841
1706,Computer Science,2010,2.87,3.11,2.901471900089206,974,147,1121
1707,Computer Science,2011,2.94,3.1,2.961942179392142,1164,185,1349
1708,Computer Science,2012,2.98,3.13,3.003196768609348,1465,268,1733
1709,Computer Science,2013,3.0,3.13,3.02187866927593,1700,344,2044
1711,Computer Science,2014,3.13,3.24,3.149608026131591,1761,382,2143
1738,Computer Science,2011,2.99,3.0,2.9912639405204464,235,34,269
1739,Computer Science,2012,3.01,2.93,2.996909090909091,322,63,385
1740,Computer Science,2013,3.1,2.96,3.0721042830540037,430,107,537
1877,Computer Science,2011,3.47,3.31,3.4304819277108436,250,82,332
1878,Computer Science,2012,3.44,3.36,3.4194022988505743,323,112,435
1906,Computer Science,2013,3.13,3.28,3.14914446002805,622,91,713
1907,Computer Science,2013,3.4,3.4,3.4000000000000004,360,131,491
1908,Computer Science,2014,3.44,3.38,3.4201298701298706,412,204,616
1952,Computer Science,2007,3.05,3.07,3.0518834080717485,404,42,446
1953,Computer Science,2008,3.02,3.13,3.0290163934426233,448,40,488
1954,Computer Science,2009,3.12,3.23,3.1317303822937625,444,53,497
1955,Computer Science,2010,3.17,3.25,3.178561403508772,509,61,570
1956,Computer Science,2011,3.14,3.3,3.1562984218077474,626,71,697
1957,Computer Science,2012,3.18,3.32,3.197342342342342,778,110,888
1958,Computer Science,2013,3.17,3.34,3.1915270018621973,938,136,1074
1969,Computer Science,2013,3.18,3.36,3.198947368421053,170,20,190
1970,Computer Science,2014,3.2,3.4,3.2270916334661357,217,34,251
2004,Computer Science,2013,3.07,3.05,3.0675551102204404,438,61,499
2008,Computer Science,2013,2.98,3.22,3.0017881705639615,661,66,727
2020,Computer Science,2012,3.08,3.25,3.099615384615385,483,63,546
2021,Computer Science,2013,3.1,3.23,3.1158934169278996,560,78,638
2022,Computer Science,2014,3.13,3.33,3.1569377382465054,681,106,787
2037,Computer Science,2011,3.01,3.07,3.015806451612903,616,66,682
2038,Computer Science,2012,3.05,3.24,3.0681067344345614,712,75,787
2039,Computer Science,2013,3.02,3.24,3.0397949886104785,799,79,878
2040,Computer Science,2014,3.0,3.09,3.0091277890466532,886,100,986
2043,Computer Science,2013,2.73,3.16,2.8075773195876286,159,35,194
2044,Computer Science,2014,2.78,3.13,2.836976744186046,180,35,215
2055,Computer Science,2013,3.12,3.15,3.1241379310344826,750,120,870
2535,Computer Science,2011,3.1,3.17,3.1085923423423427,779,109,888
2839,Computer Science,2014,2.97,3.31,2.9944800000000003,232,18,250
2840,Computer Science,2010,2.89,3.08,2.912599118942731,200,27,227
2841,Computer Science,2011,2.93,3.3,2.9585909090909097,203,17,220
3320,Computer Science,2008,3.17,3.42,3.1783333333333332,29,1,30
3802,Computer Science,2010,3.2,3.66,3.2327340823970037,248,19,267
3803,Computer Science,2011,3.24,3.69,3.291245551601424,249,32,281
3997,Computer Science,2009,3.28,3.25,3.2767,267,33,300
3998,Computer Science,2010,3.26,3.35,3.2708668730650157,284,39,323
3999,Computer Science,2011,3.27,3.34,3.2786096256684485,328,46,374
4000,Computer Science,2012,3.28,3.3,3.282429149797571,434,60,494
4001,Computer Science,2013,3.31,3.33,3.3125705329153607,556,82,638
4002,Computer Science,2014,3.33,3.345,3.332535211267606,767,156,923
4003,Computer Science,2009,3.2,3.59,3.2515094339622643,46,7,53
4004,Computer Science,2010,3.2,3.62,3.2286363636363635,41,3,44
4005,Computer Science,2011,3.35,3.12,3.322941176470588,45,6,51
4006,Computer Science,2012,3.34,3.38,3.3454320987654316,70,11,81
4007,Computer Science,2013,3.31,3.34,3.315121951219512,102,21,123
4008,Computer Science,2014,3.302,3.362,3.3138471337579616,252,62,314
4020,Computer Science,2014,2.82,3.23,2.8815,34,6,40
4026,Computer Science,2013,2.85,3.03,2.8807317073170733,34,7,41
4032,Computer Science,2012,3.07,3.53,3.123076923076923,23,3,26
4039,Computer Science,2011,3.0,2.95,2.991304347826087,19,4,23
4045,Computer Science,2010,3.21,3.36,3.2157692307692307,25,1,26
4051,Computer Science,2009,2.86,3.64,2.897142857142857,20,1,21
4120,Computer Science,2013,2.95,3.05,2.962017167381974,205,28,233
4121,Computer Science,2012,3.08,3.1,3.0817679558011046,165,16,181
4122,Computer Science,2011,2.95,3.03,2.9575675675675677,134,14,148
4123,Computer Science,2010,3.0,2.9,2.993388429752066,113,8,121
4139,Computer Science,2014,2.8,3.02,2.8245744680851064,501,63,564
4140,Computer Science,2013,2.81,2.78,2.806155339805825,449,66,515
4141,Computer Science,2012,2.89,2.86,2.8856324582338906,358,61,419
4142,Computer Science,2011,2.84,3.09,2.8705851063829786,330,46,376
4143,Computer Science,2010,2.93,2.95,2.9323076923076927,299,39,338
4145,Computer Science,2014,2.81,2.93,2.827888198757764,137,24,161
4146,Computer Science,2013,2.92,3.05,2.940347826086956,97,18,115
4147,Computer Science,2012,2.86,2.95,2.8769411764705883,69,16,85
4148,Computer Science,2011,3.11,3.02,3.093285714285714,57,13,70
4149,Computer Science,2010,2.81,3.34,2.838909090909091,52,3,55
4169,Computer Science,2014,3.02,3.21,3.040734522560336,849,104,953
4198,Computer Science,2010,2.79,3.04,2.814663677130045,201,22,223
4199,Computer Science,2011,2.82,3.09,2.8451417004048585,224,23,247
4200,Computer Science,2012,2.87,2.85,2.8678260869565215,246,30,276
4201,Computer Science,2013,2.87,3.24,2.8982802547770703,290,24,314
4202,Computer Science,2014,2.89,3.34,2.9432394366197188,313,42,355
4213,Computer Science,2010,2.86,2.98,2.8736142625607775,547,70,617
4214,Computer Science,2011,2.9,3.0,2.9103546099290782,632,73,705
4215,Computer Science,2012,2.89,3.08,2.912366790582404,712,95,807
4216,Computer Science,2013,2.93,3.16,2.9550219780219784,811,99,910
4217,Computer Science,2014,2.95,3.11,2.968938207136641,1013,136,1149
4223,Computer Science,2010,2.17,2.8,2.2487500000000002,91,13,104
4224,Computer Science,2011,2.05,1.67,2.01048,112,13,125
4225,Computer Science,2012,1.84,2.93,1.9853333333333334,130,20,150
4226,Computer Science,2013,2.0,2.06,2.0100000000000002,130,26,156
4273,Computer Science,2014,2.9,3.24,2.937777777777778,216,27,243
4297,Computer Science,2013,2.97,3.23,2.988808510638298,218,17,235
4298,Computer Science,2012,2.87,3.37,2.9107725321888416,214,19,233
4299,Computer Science,2009,2.83,3.09,2.857248908296943,205,24,229
4318,Computer Science,2014,3.19,3.17,3.1872563176895308,478,76,554
4343,Computer Science,2014,3.14,3.16,3.143507362784471,616,131,747
4348,Computer Science,2015,2.92,3.37,2.973225806451613,246,33,279
4384,Computer Science,2015,3.06,3.28,3.0859815950920244,1150,154,1304
4402,Computer Science,2012,3.18,3.23,3.186788990825688,942,148,1090
4403,Computer Science,2013,3.21,3.22,3.211672,1041,209,1250
4404,Computer Science,2014,3.28,3.29,3.2818211920529796,1235,275,1510
4405,Computer Science,2015,3.3,3.23,3.285803667745415,1478,376,1854
4430,Computer Science,2011,2.82,3.08,2.8550434782608693,199,31,230
4431,Computer Science,2012,2.78,3.0,2.806640625,225,31,256
4432,Computer Science,2013,2.89,2.66,2.8609090909090913,221,32,253
4433,Computer Science,2014,2.86,3.14,2.9,228,38,266
4449,Computer Science,2015,3.45,3.45,3.4499999999999997,441,200,641
4504,Computer Science,2012,3.22,3.48,3.249058823529412,302,38,340
4505,Computer Science,2013,3.43,3.3,3.4155555555555557,376,47,423
4506,Computer Science,2014,3.33,3.21,3.3151476793248946,623,88,711
4517,Computer Science,2014,3.05,3.14,3.068082191780822,525,132,657
4519,Computer Science,2014,2.54,2.79,2.571609195402299,152,22,174
4547,Computer Science,2010,2.82,2.77,2.8126829268292686,175,30,205
4627,Computer Science,2010,2.88,3.09,2.9039792387543253,256,33,289
4628,Computer Science,2011,2.88,2.98,2.8894076655052263,260,27,287
4629,Computer Science,2012,2.92,2.92,2.92,314,38,352
4630,Computer Science,2013,2.92,3.09,2.9391494252873565,386,49,435
4631,Computer Science,2014,2.97,3.15,2.992964352720451,465,68,533
4632,Computer Science,2015,3.02,3.19,3.0442857142857145,540,90,630
4704,Computer Science,2015,3.03,3.06,3.035498043936202,2714,609,3323
4729,Computer Science,2015,3.423,3.438,3.4247070895522387,475,61,536
4766,Computer Science,2015,2.98,3.311,3.16021778584392,251,300,551
4771,Computer Science,2015,3.0,3.0,3.0,306,61,367
4799,Computer Science,2010,3.09,3.02,3.084814814814815,50,4,54
4800,Computer Science,2011,3.01,3.77,3.0598360655737706,57,4,61
4803,Computer Science,2013,3.06,2.92,3.053,57,3,60
4804,Computer Science,2014,3.1,3.26,3.1127999999999996,92,8,100
4850,Computer Science,2015,3.297,3.412,3.324658227848101,300,95,395
4851,Computer Science,2015,3.33,3.345,3.3326934097421206,859,188,1047
4852,Computer Science,2016,3.14,3.44,3.195985915492958,231,53,284
4857,Computer Science,2016,2.82,3.38,2.939344262295082,48,13,61
4858,Computer Science,2015,2.48,2.82,2.5243478260869567,40,6,46
4872,Computer Science,2015,3.3,3.2,3.2866666666666666,247,38,285
4878,Computer Science,2015,3.06,3.3,3.0986813186813187,229,44,273
4885,Computer Science,2016,3.42,3.4,3.4134032983508242,447,220,667
4902,Computer Science,2016,4.03,4.03,4.03,527,227,754
4904,Computer Science,2011,3.19,3.17,3.188117386489479,818,85,903
4905,Computer Science,2012,3.18,3.16,3.1783284742468414,943,86,1029
4906,Computer Science,2013,3.3,3.16,3.2837681159420287,976,128,1104
4907,Computer Science,2014,3.38,3.35,3.374995744680851,979,196,1175
4908,Computer Science,2015,3.45,3.37,3.434480686695279,939,226,1165
4932,Computer Science,2015,2.95,3.3,3.0125912408759126,225,49,274
4933,Computer Science,2016,3.04,3.12,3.055250836120402,242,57,299
4936,Computer Science,2016,3.2,3.2,3.1999999999999997,1620,487,2107
4996,Computer Science,2015,2.89,3.32,2.942121212121213,406,56,462
5216,Computer Science,2014,2.03,2.35,2.0761691542288556,172,29,201
5217,Computer Science,2015,2.15,3.15,2.273552123552123,227,32,259
5234,Computer Science,2015,3.1,3.36,3.1304504504504505,196,26,222
5261,Computer Science,2015,2.9,2.94,2.9065000000000003,603,117,720
5270,Computer Science,2015,3.19,3.32,3.208590130916415,851,142,993
5292,Computer Science,2011,2.71,3.07,2.7534117647058824,299,41,340
5293,Computer Science,2012,2.75,2.88,2.7641225626740944,320,39,359
5294,Computer Science,2013,2.75,2.78,2.753563714902808,408,55,463
5295,Computer Science,2014,2.8,2.7,2.787403100775194,451,65,516
5296,Computer Science,2015,2.82,2.93,2.83445434298441,390,59,449
5336,Computer Science,2013,2.71,2.94,2.7356928034371646,827,104,931
5337,Computer Science,2014,2.72,2.9,2.74275092936803,940,136,1076
5354,Computer Science,2015,2.79,2.91,2.8067188788128608,1044,169,1213
1454,Computer Science (BS),2004,2.7,3.2,2.76,44,6,50
1455,Computer Science (BS),2005,2.9,3.2,2.945,34,6,40
1457,Computer Science (BS),2007,3.56,3.71,3.5740624999999997,29,3,32
3314,Computer Science (BS),2008,3.47,2.27,3.4384210526315795,37,1,38
3519,Computer Science (BS),2010,3.07,3.14,3.08009009009009,190,32,222
3520,Computer Science (BS),2011,3.04,3.07,3.0449003984063743,210,41,251
4071,Computer Science (BS),2012,3.13,3.09,3.1244871794871796,269,43,312
4072,Computer Science (BS),2013,3.16,3.17,3.161495327102804,273,48,321
4073,Computer Science (BS),2014,3.18,3.41,3.2125066666666666,322,53,375
4260,Computer Science (BS),2014,3.07,3.28,3.099423076923077,313,51,364
4357,Computer Science (BS),2015,3.16,3.24,3.1730022573363432,371,72,443
4415,Computer Science (BS),2010,2.82,2.85,2.8232374100719424,124,15,139
4416,Computer Science (BS),2011,2.86,2.83,2.8566666666666665,160,20,180
4417,Computer Science (BS),2012,2.87,3.06,2.8948598130841123,186,28,214
4418,Computer Science (BS),2013,2.94,2.95,2.941207547169811,233,32,265
4419,Computer Science (BS),2014,2.86,3.05,2.8842156862745094,267,39,306
4526,Computer Science (BS),2014,3.45,3.51,3.461521739130435,223,53,276
4527,Computer Science (BS),2013,3.4,3.24,3.372017937219731,184,39,223
4528,Computer Science (BS),2012,3.32,3.17,3.290703125,103,25,128
4529,Computer Science (BS),2011,3.28,3.39,3.2970103092783507,82,15,97
4530,Computer Science (BS),2010,3.4,3.55,3.418072289156626,73,10,83
4794,Computer Science (BS),2010,3.09,3.47,3.118148148148148,50,4,54
4795,Computer Science (BS),2011,3.31,3.44,3.3174285714285716,66,4,70
4797,Computer Science (BS),2012,3.09,3.48,3.1143749999999994,60,4,64
4798,Computer Science (BS),2013,3.24,2.97,3.2265,57,3,60
4815,Computer Science (BS),2015,3.46,3.58,3.4842815249266863,272,69,341
4899,Computer Science (BS),2015,2.81,3.08,2.840626865671642,297,38,335
1450,Computer Science (BA),2004,2.5,2.45,2.4921875,54,10,64
1451,Computer Science (BA),2005,2.4,2.2,2.370967741935484,53,9,62
3308,Computer Science (BA),2008,2.81,3.89,2.8930769230769227,84,7,91
3309,Computer Science (BA),2009,2.9,3.22,2.9242016806722693,110,9,119
4069,Computer Science (BA),2013,2.71,3.19,2.757719298245614,154,17,171
4070,Computer Science (BA),2014,2.76,2.84,2.7699208443271766,332,47,379
4252,Computer Science (BA),2014,3.06,3.05,3.0580645161290323,50,12,62
4356,Computer Science (BA),2015,2.67,2.84,2.6898058252427184,455,60,515
4410,Computer Science (BA),2010,2.79,3.27,2.9070731707317075,31,10,41
4412,Computer Science (BA),2012,2.67,2.38,2.623863636363636,37,7,44
4413,Computer Science (BA),2013,2.7,3.2,2.7222222222222223,43,2,45
4414,Computer Science (BA),2014,2.63,2.55,2.62375,59,5,64
4521,Computer Science (BA),2014,3.52,3.59,3.5395081967213113,44,17,61
4522,Computer Science (BA),2013,3.42,3.56,3.461034482758621,41,17,58
4523,Computer Science (BA),2012,3.37,3.22,3.3303773584905665,39,14,53
4524,Computer Science (BA),2011,3.38,3.43,3.390576923076923,41,11,52
4525,Computer Science (BA),2010,3.31,3.54,3.3459375000000002,27,5,32
4702,Computer Science (BA),2015,3.5,3.2,3.433333333333333,7,2,9
4787,Computer Science (BA),2010,2.76,3.15,2.8103225806451606,81,12,93
4788,Computer Science (BA),2011,3.03,2.74,3.0058333333333334,88,8,96
4789,Computer Science (BA),2012,3.05,3.27,3.0721705426356585,116,13,129
4790,Computer Science (BA),2013,2.85,3.45,2.9023809523809523,115,11,126
4791,Computer Science (BA),2014,3.0,3.31,3.0241558441558443,142,12,154
4792,Computer Science (BA),2015,2.99,3.23,3.0129213483146073,161,17,178
4814,Computer Science (BA),2015,3.51,3.25,3.4214285714285717,60,31,91
4900,Computer Science (BA),2015,2.71,3.23,2.77,92,12,104
4156,Computer Software and Media Applications,2013,3.1,3.03,3.0878260869565217,19,4,23
4157,Computer Software and Media Applications,2012,2.9,3.1,2.92,27,3,30
4158,Computer Software and Media Applications,2011,2.9,3.2,2.93125,43,5,48
4159,Computer Software and Media Applications,2010,3.0,3.1,3.0209302325581397,34,9,43
4658,Computer Software and Media Applications,2015,2.91,3.21,2.9989175257731957,273,115,388
4659,Computer Software and Media Applications,2014,2.86,3.05,2.916584699453552,257,109,366
4662,Computer Software and Media Applications,2013,2.92,3.18,2.9915384615384615,245,93,338
4663,Computer Software and Media Applications,2012,2.93,3.07,2.963067484662577,249,77,326
4664,Computer Software and Media Applications,2011,2.9,3.12,2.9526086956521738,280,88,368
4667,Computer Software and Media Applications,2010,2.91,3.12,2.957867647058824,315,93,408
4668,Computer Software and Media Applications,2009,2.9,3.14,2.94979020979021,340,89,429
4669,Computer Software and Media Applications,2008,2.9,3.19,2.9542978723404256,382,88,470
4770,Computer Software and Media Applications,2015,2.9,3.4,3.082692307692308,33,19,52
4893,Computer Software and Media Applications,2010,2.91,3.021,2.9793749999999997,9,15,24
4894,Computer Software and Media Applications,2011,2.909,3.295,3.142939393939394,13,20,33
4895,Computer Software and Media Applications,2012,2.76,3.287,3.031028571428571,17,18,35
4896,Computer Software and Media Applications,2013,2.748,3.345,3.099176470588236,14,20,34
4897,Computer Software and Media Applications,2014,2.925,3.291,3.146818181818182,13,20,33
5280,Computer Software and Media Applications,2016,2.95,3.15,3.0109090909090908,306,134,440
1396,Networking,2004,3.03,3.2,3.0378242677824265,228,11,239
1397,Networking,2005,2.98,3.05,2.983522012578616,302,16,318
1398,Networking,2006,3.02,3.02,3.02,363,14,377
1399,Networking,2007,3.06,2.91,3.053706293706294,411,18,429
1302,Applied Engineering Sciences,2008,3.0,3.1,3.030357142857143,117,51,168
1303,Applied Engineering Sciences,2009,3.1,3.3,3.15945945945946,104,44,148
1304,Applied Engineering Sciences,2010,3.1,3.3,3.151807228915663,123,43,166
1305,Applied Engineering Sciences,2011,3.1,3.3,3.145238095238095,130,38,168
4027,General Engineering,2013,2.75,2.98,2.787734375,107,21,128
4052,General Engineering,2009,3.37,3.38,3.372021276595745,75,19,94
4058,General Engineering,2011,3.0,3.0,3.0,59,15,74
4856,General Engineering,2016,4.0,3.5,3.9151785714285716,93,19,112
4059,Aerospace Engineering,2010,3.3,3.21,3.282427440633245,305,74,379
4060,Aerospace Engineering,2011,3.25,3.22,3.243985507246377,331,83,414
4061,Aerospace Engineering,2012,3.26,3.17,3.242211764705882,341,84,425
4062,Aerospace Engineering,2013,3.24,3.36,3.2640000000000002,352,88,440
4063,Aerospace Engineering,2014,3.19,3.25,3.200379746835443,392,82,474
4208,Aerospace Engineering,2010,2.87,2.99,2.891818181818182,387,86,473
4209,Aerospace Engineering,2011,2.83,2.83,2.83,461,90,551
4210,Aerospace Engineering,2012,2.85,2.94,2.864241435562806,516,97,613
4211,Aerospace Engineering,2013,2.91,3.02,2.9251044776119404,578,92,670
4212,Aerospace Engineering,2014,2.83,3.01,2.853092105263158,530,78,608
4355,Aerospace Engineering,2015,3.26,3.24,3.256459510357815,437,94,531
1310,Chemical Engineering,2008,3.2,3.2,3.2,245,86,331
1311,Chemical Engineering,2009,3.2,3.3,3.2235632183908045,266,82,348
1312,Chemical Engineering,2010,3.2,3.2,3.2,293,83,376
1313,Chemical Engineering,2011,3.1,3.3,3.1445497630331753,328,94,422
2014,Chemical Engineering,2012,3.15,3.22,3.1665236051502146,356,110,466
2015,Chemical Engineering,2013,3.15,3.28,3.182673796791444,420,141,561
2016,Chemical Engineering,2014,3.08,3.33,3.1405815831987076,469,150,619
1314,Civil Engineering,2008,3.1,3.2,3.116253443526171,304,59,363
1315,Civil Engineering,2009,3.0,3.2,3.0375661375661376,307,71,378
1316,Civil Engineering,2010,3.1,3.2,3.119667590027701,290,71,361
1317,Civil Engineering,2011,3.1,3.1,3.1,315,67,382
2041,Civil Engineering,2013,2.8,2.92,2.8369230769230764,144,64,208
2042,Civil Engineering,2014,2.93,3.02,2.9545454545454546,128,48,176
4022,Civil Engineering,2014,3.05,3.36,3.1022891566265063,69,14,83
4028,Civil Engineering,2013,3.11,3.44,3.1732876712328766,59,14,73
4035,Civil Engineering,2012,3.09,3.36,3.162857142857143,46,17,63
4041,Civil Engineering,2011,2.95,3.33,3.040985915492958,54,17,71
4047,Civil Engineering,2010,3.1,3.48,3.1838235294117645,53,15,68
4053,Civil Engineering,2009,3.03,3.4,3.1081690140845066,56,15,71
4930,Civil Engineering,2015,2.93,3.02,2.956780487804878,144,61,205
4931,Civil Engineering,2016,2.95,3.02,2.9738955823293174,164,85,249
1259,Computer Engineering,2009,2.75,2.75,2.75,142,20,162
1260,Computer Engineering,2010,2.74,2.88,2.759515151515152,142,23,165
1261,Computer Engineering,2011,2.77,2.63,2.747633136094674,142,27,169
1262,Computer Engineering,2012,2.67,2.8,2.688012048192771,143,23,166
1318,Computer Engineering,2008,3.0,3.1,3.0112994350282487,157,20,177
1319,Computer Engineering,2009,3.0,3.1,3.01044776119403,180,21,201
1320,Computer Engineering,2010,3.0,2.8,2.978095238095238,187,23,210
1321,Computer Engineering,2011,2.9,2.7,2.884976525821596,197,16,213
1414,Computer Engineering,2004,2.97,2.97,2.97,99,16,115
1415,Computer Engineering,2005,2.97,2.92,2.9646236559139787,83,10,93
1416,Computer Engineering,2006,2.89,3.08,2.9074489795918375,89,9,98
1417,Computer Engineering,2007,2.85,3.2,2.8911764705882352,75,10,85
1418,Computer Engineering,2008,2.79,3.19,2.8384848484848484,87,12,99
1419,Computer Engineering,2009,2.99,3.1,3.0100869565217394,94,21,115
1420,Computer Engineering,2003,2.89,2.96,2.902939393939394,269,61,330
1421,Computer Engineering,2004,2.83,3.11,2.8725185185185187,229,41,270
1422,Computer Engineering,2005,2.93,3.15,2.958039215686275,178,26,204
1423,Computer Engineering,2006,3.02,2.9,3.013532934131737,158,9,167
1424,Computer Engineering,2007,2.83,2.85,2.8314545454545454,153,12,165
1425,Computer Engineering,2008,2.91,2.47,2.891917808219178,140,6,146
1426,Computer Engineering,2009,3.01,2.91,3.004666666666666,142,8,150
1427,Computer Engineering,2010,2.98,3.28,2.999014084507042,133,9,142
1428,Computer Engineering,2011,2.98,3.13,2.987241379310345,138,7,145
1429,Computer Engineering,2012,3.3,3.3,3.3,138,10,148
1475,Computer Engineering,2008,2.83,3.0,2.8480303030303036,177,21,198
1484,Computer Engineering,2009,2.96,3.02,2.966936416184971,153,20,173
1485,Computer Engineering,2010,3.0,3.25,3.027327935222672,220,27,247
1486,Computer Engineering,2011,2.94,3.04,2.9482608695652175,211,19,230
1487,Computer Engineering,2012,2.96,3.16,2.9811604095563142,262,31,293
1510,Computer Engineering,2008,2.67,2.83,2.6870000000000003,143,17,160
1511,Computer Engineering,2009,2.7,2.52,2.6796610169491526,157,20,177
1512,Computer Engineering,2010,2.65,2.95,2.681578947368421,170,20,190
1513,Computer Engineering,2011,2.76,3.13,2.80625,154,22,176
1514,Computer Engineering,2012,2.71,2.92,2.7343157894736843,168,22,190
1572,Computer Engineering,2009,2.98,2.99,2.9816134185303516,525,101,626
1573,Computer Engineering,2010,2.41,2.51,2.425696649029982,478,89,567
1574,Computer Engineering,2011,2.48,2.56,2.4929850746268656,449,87,536
1690,Computer Engineering,2009,2.89,2.93,2.8947368421052633,201,27,228
1691,Computer Engineering,2010,2.83,3.01,2.85109375,226,30,256
1692,Computer Engineering,2011,2.79,2.94,2.8077700348432058,253,34,287
1693,Computer Engineering,2012,2.85,2.87,2.85225988700565,314,40,354
1903,Computer Engineering,2013,3.16,3.17,3.160911680911681,319,32,351
2006,Computer Engineering,2013,3.02,2.99,3.018308270676692,251,15,266
2009,Computer Engineering,2013,3.0,3.18,3.015199374511337,1171,108,1279
2012,Computer Engineering,2013,2.6,2.83,2.62355421686747,149,17,166
2017,Computer Engineering,2012,2.9,2.98,2.9075117370892016,193,20,213
2018,Computer Engineering,2013,3.0,3.2,3.0176706827309236,227,22,249
2019,Computer Engineering,2014,3.05,3.25,3.068421052631579,276,28,304
2053,Computer Engineering,2013,2.99,2.94,2.9840972222222226,381,51,432
2071,Computer Engineering,2011,3.21,3.47,3.263793103448276,23,6,29
2072,Computer Engineering,2012,3.42,3.17,3.382121212121212,28,5,33
2073,Computer Engineering,2013,3.24,3.56,3.290196078431373,43,8,51
2074,Computer Engineering,2014,3.29,3.5,3.31953125,55,9,64
4023,Computer Engineering,2014,3.22,3.02,3.1654545454545455,16,6,22
4029,Computer Engineering,2013,3.12,3.54,3.2188235294117646,13,4,17
4036,Computer Engineering,2012,2.78,3.37,2.870769230769231,11,2,13
4042,Computer Engineering,2011,3.15,3.49,3.1900000000000004,15,2,17
4054,Computer Engineering,2009,3.33,2.71,3.288666666666667,14,1,15
4129,Computer Engineering,2010,2.9,3.2,2.921428571428571,91,7,98
4131,Computer Engineering,2013,2.9,3.33,2.9469090909090907,98,12,110
4132,Computer Engineering,2012,2.9,3.2,2.9342857142857146,93,12,105
4133,Computer Engineering,2011,2.9,3.1,2.9176470588235293,93,9,102
4144,Computer Engineering,2014,2.96,3.27,3.004285714285714,6,1,7
4203,Computer Engineering,2010,2.82,2.85,2.822222222222222,75,6,81
4204,Computer Engineering,2011,2.62,3.01,2.662289156626506,74,9,83
4205,Computer Engineering,2012,2.64,2.43,2.623103448275862,80,7,87
4206,Computer Engineering,2013,2.85,2.85,2.85,100,7,107
4207,Computer Engineering,2014,2.95,2.22,2.905948275862069,109,7,116
4218,Computer Engineering,2010,2.78,3.04,2.8094581280788176,360,46,406
4219,Computer Engineering,2011,2.83,2.78,2.825104166666667,433,47,480
4220,Computer Engineering,2012,2.86,2.85,2.8589711191335736,497,57,554
4221,Computer Engineering,2013,2.92,2.87,2.913814432989691,510,72,582
4222,Computer Engineering,2014,2.89,2.9,2.891028667790894,532,61,593
4279,Computer Engineering,2014,2.94,3.25,2.9628138528138526,214,17,231
4280,Computer Engineering,2013,2.93,3.07,2.9418222222222226,206,19,225
4281,Computer Engineering,2012,2.95,2.97,2.9514563106796117,191,15,206
4282,Computer Engineering,2011,2.9,3.01,2.9080487804878046,190,15,205
4283,Computer Engineering,2010,2.91,3.02,2.9183856502242156,206,17,223
4284,Computer Engineering,2009,2.87,3.01,2.8772641509433963,201,11,212
4334,Computer Engineering,2014,3.05,2.89,3.035329512893983,317,32,349
4349,Computer Engineering,2015,3.05,3.07,3.051391304347826,214,16,230
4775,Computer Engineering,2015,3.0,2.8,2.9718518518518517,116,19,135
4861,Computer Engineering,2015,3.25,3.2,3.2384615384615385,20,6,26
4862,Computer Engineering,2016,3.19,3.37,3.2240540540540543,30,7,37
4867,Computer Engineering,2013,3.3,3.3,3.3,142,18,160
4868,Computer Engineering,2014,3.2,3.3,3.209473684210526,172,18,190
4869,Computer Engineering,2015,3.3,3.2,3.2879999999999994,176,24,200
4886,Computer Engineering,2010,3.046,3.221,3.0832047244094483,100,27,127
4887,Computer Engineering,2011,3.026,3.151,3.0483509933774835,124,27,151
4888,Computer Engineering,2012,2.989,3.137,3.0121508379888264,151,28,179
4889,Computer Engineering,2013,3.127,3.179,3.1335631067961165,180,26,206
4890,Computer Engineering,2014,3.128,3.139,3.129484429065744,250,39,289
4892,Computer Engineering,2016,2.947,2.945,2.946630498533724,278,63,341
4997,Computer Engineering,2015,2.81,2.85,2.8113513513513513,143,5,148
1402,Software Engineering,2006,3.01,3.14,3.017959183673469,322,21,343
1403,Software Engineering,2007,2.98,3.09,2.9868749999999995,330,22,352
1966,Software Engineering,2011,2.76,3.04,2.7925581395348837,38,5,43
1967,Software Engineering,2012,2.95,2.58,2.8957333333333333,64,11,75
1968,Software Engineering,2013,2.86,2.88,2.8619565217391307,166,18,184
1981,Software Engineering,2013,2.93,2.99,2.937924528301887,46,7,53
4291,Software Engineering,2014,2.89,2.61,2.8744444444444444,85,5,90
4292,Software Engineering,2013,2.78,2.8,2.7809638554216862,79,4,83
4293,Software Engineering,2012,3.0,2.52,2.978181818181818,63,3,66
4294,Software Engineering,2011,2.94,3.06,2.9448000000000003,48,2,50
4296,Software Engineering,2009,2.95,2.64,2.94515625,63,1,64
4346,Software Engineering,2015,3.0,2.96,2.998279569892473,89,4,93
1263,Electrical Engineering,2009,2.85,3.09,2.8908510638297873,195,40,235
1264,Electrical Engineering,2010,2.8,3.06,2.836833333333333,206,34,240
1265,Electrical Engineering,2011,2.83,3.12,2.8685062240663903,209,32,241
1266,Electrical Engineering,2012,2.63,2.86,2.6653846153846152,231,42,273
1328,Electrical Engineering,2008,3.1,3.1,3.1,272,27,299
1329,Electrical Engineering,2009,3.1,3.0,3.090909090909091,260,26,286
1330,Electrical Engineering,2010,3.1,3.2,3.1092024539877303,296,30,326
1331,Electrical Engineering,2011,3.1,3.2,3.1110552763819097,354,44,398
1440,Electrical Engineering,2003,2.81,3.05,2.850216216216216,154,31,185
1441,Electrical Engineering,2004,3.0,3.04,3.0063030303030303,139,26,165
1442,Electrical Engineering,2005,3.11,3.14,3.115925925925926,130,32,162
1443,Electrical Engineering,2006,3.09,3.11,3.0937288135593217,144,33,177
1444,Electrical Engineering,2007,3.0,2.93,2.990191082802548,135,22,157
1445,Electrical Engineering,2008,3.14,3.26,3.155089820359281,146,21,167
1446,Electrical Engineering,2009,3.1,3.19,3.1104268292682926,145,19,164
1447,Electrical Engineering,2010,3.12,3.07,3.114186046511628,152,20,172
1448,Electrical Engineering,2011,2.98,3.12,2.9967664670658687,147,20,167
1449,Electrical Engineering,2012,3.3,3.3,3.3,150,18,168
1532,Electrical Engineering,2008,2.92,3.16,2.9331506849315065,207,12,219
1533,Electrical Engineering,2009,2.87,3.14,2.889205020920502,222,17,239
1534,Electrical Engineering,2010,2.9,3.01,2.910905172413793,209,23,232
1535,Electrical Engineering,2011,3.05,3.09,3.0534782608695648,189,18,207
1536,Electrical Engineering,2012,3.01,3.11,3.0166371681415924,211,15,226
1575,Electrical Engineering,2009,2.99,3.11,3.010661157024794,601,125,726
1576,Electrical Engineering,2010,2.44,2.76,2.490793650793651,530,100,630
1577,Electrical Engineering,2011,2.45,2.68,2.4867563291139243,531,101,632
1665,Electrical Engineering,2004,3.01,2.94,3.0030434782608695,290,32,322
1666,Electrical Engineering,2005,3.02,2.88,3.0023650385604115,340,49,389
1667,Electrical Engineering,2006,3.08,2.92,3.0619839142091156,331,42,373
1668,Electrical Engineering,2007,3.01,2.84,2.992431610942249,295,34,329
1669,Electrical Engineering,2008,3.04,2.89,3.023079268292683,291,37,328
1670,Electrical Engineering,2009,2.98,2.88,2.9683720930232553,266,35,301
1671,Electrical Engineering,2010,2.97,2.95,2.9677926421404686,266,33,299
1672,Electrical Engineering,2011,3.03,3.05,3.03225352112676,315,40,355
1673,Electrical Engineering,2012,3.05,3.03,3.048045112781955,360,39,399
1905,Electrical Engineering,2013,3.21,3.32,3.221801619433198,441,53,494
1971,Electrical Engineering,2007,2.99,2.99,2.9899999999999998,457,66,523
1972,Electrical Engineering,2008,3.04,3.04,3.0399999999999996,446,71,517
1973,Electrical Engineering,2009,3.0,3.07,3.008546511627907,453,63,516
1974,Electrical Engineering,2010,3.08,3.23,3.099702276707531,496,75,571
1975,Electrical Engineering,2011,3.07,3.25,3.0923529411764705,536,76,612
1976,Electrical Engineering,2012,3.13,3.27,3.1469401947148814,632,87,719
1977,Electrical Engineering,2013,3.12,3.12,3.12,728,88,816
1978,Electrical Engineering,2013,2.96,3.11,2.97,84,6,90
1993,Electrical Engineering,2013,3.04,3.12,3.050450450450451,386,58,444
2007,Electrical Engineering,2003,2.9,3.01,2.911464788732394,318,37,355
2011,Electrical Engineering,2013,2.83,3.08,2.864296028880866,239,38,277
2023,Electrical Engineering,2012,3.13,3.25,3.1427536231884057,370,44,414
2024,Electrical Engineering,2013,3.08,3.13,3.0848314606741574,402,43,445
2025,Electrical Engineering,2014,3.1,3.17,3.107947598253275,406,52,458
2045,Electrical Engineering,2013,3.03,3.42,3.07984962406015,232,34,266
2046,Electrical Engineering,2014,3.08,3.29,3.108671586715867,234,37,271
4024,Electrical Engineering,2014,3.15,3.57,3.185421686746988,76,7,83
4030,Electrical Engineering,2013,3.25,3.54,3.2983333333333333,55,11,66
4037,Electrical Engineering,2012,3.2,3.44,3.2380952380952386,53,10,63
4043,Electrical Engineering,2011,3.11,3.34,3.1514754098360656,50,11,61
4049,Electrical Engineering,2010,3.2,3.21,3.201509433962264,45,8,53
4055,Electrical Engineering,2009,3.2,3.39,3.231666666666667,40,8,48
4151,Electrical Engineering,2013,2.9,3.1,2.931111111111111,114,21,135
4152,Electrical Engineering,2012,3.0,3.2,3.0322033898305087,99,19,118
4153,Electrical Engineering,2011,2.9,3.0,2.9150943396226414,90,16,106
4154,Electrical Engineering,2010,2.9,2.99,2.9059504132231404,113,8,121
4161,Electrical Engineering,2013,2.9,3.1,2.913953488372093,40,3,43
4162,Electrical Engineering,2012,3.0,3.1,3.010810810810811,33,4,37
4163,Electrical Engineering,2011,2.88,2.8,2.8735999999999997,23,2,25
4164,Electrical Engineering,2010,2.8,3.45,2.8649999999999998,18,2,20
4171,Electrical Engineering,2010,2.78,2.49,2.7316666666666665,30,6,36
4172,Electrical Engineering,2011,2.28,2.6,2.347132867132867,113,30,143
4173,Electrical Engineering,2012,2.46,2.66,2.5029752066115702,95,26,121
4174,Electrical Engineering,2013,2.57,2.57,2.57,68,24,92
4175,Electrical Engineering,2014,2.4,2.82,2.474430379746835,65,14,79
4193,Electrical Engineering,2014,2.98,3.27,3.006593886462882,208,21,229
4194,Electrical Engineering,2013,2.95,3.13,2.9638461538461542,204,17,221
4195,Electrical Engineering,2012,2.94,3.03,2.946769911504425,209,17,226
4196,Electrical Engineering,2011,2.97,3.0,2.9727142857142854,191,19,210
4197,Electrical Engineering,2010,2.94,3.21,2.9703061224489797,174,22,196
4285,Electrical Engineering,2014,3.01,3.23,3.0331210191082802,281,33,314
4286,Electrical Engineering,2013,3.03,2.98,3.024578313253012,296,36,332
4287,Electrical Engineering,2012,3.01,3.1,3.020093457943925,285,36,321
4288,Electrical Engineering,2011,2.96,2.9,2.9529746835443036,279,37,316
4289,Electrical Engineering,2010,2.93,3.09,2.9475147928994088,301,37,338
4290,Electrical Engineering,2009,2.97,3.15,2.9891596638655464,319,38,357
4347,Electrical Engineering,2015,2.98,3.17,3.0050943396226417,276,42,318
4426,Electrical Engineering,2011,2.82,3.01,2.846206896551724,225,36,261
4427,Electrical Engineering,2013,2.91,2.07,2.826,207,23,230
4428,Electrical Engineering,2014,2.91,3.04,2.9275675675675674,224,35,259
4429,Electrical Engineering,2012,2.82,2.93,2.8341796875000003,223,33,256
4549,Electrical Engineering,2010,2.84,2.97,2.854669260700389,228,29,257
4590,Electrical Engineering,2009,2.99,3.27,3.019553450608931,661,78,739
4591,Electrical Engineering,2010,2.91,3.17,2.9390570430733414,763,96,859
4592,Electrical Engineering,2011,2.98,3.08,2.9922736418511064,872,122,994
4593,Electrical Engineering,2012,2.96,3.01,2.9669767441860464,925,150,1075
4594,Electrical Engineering,2013,2.87,2.8,2.8603339350180503,955,153,1108
4595,Electrical Engineering,2014,3.03,2.91,3.013689320388349,712,112,824
4769,Electrical Engineering,2015,3.0,3.3,3.0428571428571427,120,20,140
4774,Electrical Engineering,2015,3.0,3.1,3.019230769230769,42,10,52
4813,Electrical Engineering,2014,3.14,3.19,3.1465789473684214,33,5,38
4821,Electrical Engineering,2014,2.64,2.94,2.6850980392156862,130,23,153
4822,Electrical Engineering,2013,2.71,2.76,2.7170312500000002,110,18,128
4823,Electrical Engineering,2012,2.69,2.43,2.6515492957746476,121,21,142
4824,Electrical Engineering,2011,2.98,2.74,2.952727272727273,117,15,132
4825,Electrical Engineering,2010,2.76,2.73,2.7562499999999996,126,18,144
4854,Electrical Engineering,2016,2.22,2.34,2.236764705882353,234,38,272
4859,Electrical Engineering,2015,3.27,3.46,3.3030434782608693,76,16,92
4860,Electrical Engineering,2016,3.13,3.48,3.181123595505618,76,13,89
4874,Electrical Engineering,2013,3.4,3.2,3.3712643678160914,149,25,174
4875,Electrical Engineering,2014,3.4,3.5,3.416751269035533,164,33,197
4876,Electrical Engineering,2015,3.5,3.6,3.5179723502304148,178,39,217
4880,Electrical Engineering,2015,2.77,2.89,2.7856521739130433,240,36,276
4882,Electrical Engineering,2015,3.02,3.22,3.0479069767441858,703,114,817
4901,Electrical Engineering,2015,2.97,2.71,2.9463636363636363,60,6,66
4934,Electrical Engineering,2015,2.93,3.05,2.947142857142857,252,42,294
4935,Electrical Engineering,2016,3.0,3.17,3.0293636363636365,273,57,330
4998,Electrical Engineering,2015,2.91,3.39,2.949069767441861,237,21,258
5264,Electrical Engineering,2015,2.76,2.77,2.7617085427135675,165,34,199
1332,Materials Science and Engineering,2008,3.2,3.4,3.2518518518518515,60,21,81
1333,Materials Science and Engineering,2009,3.1,3.4,3.175,54,18,72
1334,Materials Science and Engineering,2010,3.1,3.4,3.189189189189189,52,22,74
1335,Materials Science and Engineering,2011,3.0,3.3,3.0857142857142854,60,24,84
1336,Mechanical Engineering,2008,3.2,3.2,3.2,608,82,690
1337,Mechanical Engineering,2009,3.2,3.2,3.2000000000000006,628,90,718
1338,Mechanical Engineering,2010,3.2,3.2,3.2,644,110,754
1339,Mechanical Engineering,2011,3.2,3.4,3.2258210645526613,769,114,883
1494,Mechanical Engineering,2009,2.89,3.04,2.907268623024831,392,51,443
1495,Mechanical Engineering,2010,2.92,3.09,2.939326315789473,421,54,475
1496,Mechanical Engineering,2011,2.9,3.22,2.9396638655462186,417,59,476
1497,Mechanical Engineering,2012,2.96,3.26,3.003917525773196,414,71,485
1543,Mechanical Engineering,2008,2.85,3.13,2.868353658536585,613,43,656
1544,Mechanical Engineering,2009,2.83,3.07,2.8442541436464084,681,43,724
1545,Mechanical Engineering,2010,2.85,2.97,2.8585594405594406,664,51,715
1546,Mechanical Engineering,2011,2.85,3.01,2.8609871244635197,651,48,699
1547,Mechanical Engineering,2012,2.85,3.01,2.8591978609625666,705,43,748
1578,Mechanical Engineering,2009,3.1,3.17,3.1149429223744294,689,187,876
1579,Mechanical Engineering,2010,2.73,2.74,2.7322425952045135,550,159,709
1580,Mechanical Engineering,2011,2.61,2.79,2.646968838526912,561,145,706
1674,Mechanical Engineering,2003,2.87,3.01,2.885978260869565,652,84,736
1675,Mechanical Engineering,2004,2.93,3.14,2.9540152477763657,697,90,787
1676,Mechanical Engineering,2005,2.98,3.14,2.9956743002544535,709,77,786
1677,Mechanical Engineering,2006,3.07,3.16,3.0779847908745244,719,70,789
1678,Mechanical Engineering,2007,3.06,3.1,3.063821339950372,729,77,806
1679,Mechanical Engineering,2008,3.08,3.15,3.0875697674418605,767,93,860
1680,Mechanical Engineering,2009,3.06,3.12,3.0669405405405405,818,107,925
1681,Mechanical Engineering,2010,3.09,3.15,3.0965106382978727,838,102,940
1682,Mechanical Engineering,2011,3.07,3.12,3.074692387904067,869,90,959
1904,Mechanical Engineering,2013,3.3,3.27,3.2971372549019606,692,73,765
2026,Mechanical Engineering,2012,3.18,3.3,3.1953474320241693,866,127,993
2027,Mechanical Engineering,2013,3.15,3.27,3.1673737373737376,1016,172,1188
2028,Mechanical Engineering,2014,3.15,3.23,3.161777269260107,1118,193,1311
2075,Mechanical Engineering,2011,3.31,3.18,3.2781322957198444,194,63,257
2076,Mechanical Engineering,2012,3.29,3.13,3.2475384615384617,191,69,260
2077,Mechanical Engineering,2013,3.33,3.25,3.3120289855072462,214,62,276
2078,Mechanical Engineering,2014,3.35,3.35,3.35,242,67,309
4025,Mechanical Engineering,2014,3.14,3.3,3.163157894736842,130,22,152
4031,Mechanical Engineering,2013,3.16,3.11,3.1556140350877193,104,10,114
4038,Mechanical Engineering,2012,3.16,3.32,3.1823655913978497,80,13,93
4044,Mechanical Engineering,2011,3.07,3.13,3.0782191780821915,63,10,73
4050,Mechanical Engineering,2010,3.07,3.57,3.150459770114942,73,14,87
4056,Mechanical Engineering,2009,3.1,3.68,3.213608247422681,78,19,97
4064,Mechanical Engineering,2010,3.2,3.35,3.222929936305733,399,72,471
4065,Mechanical Engineering,2011,3.13,3.44,3.1746168224299067,458,77,535
4066,Mechanical Engineering,2012,3.14,3.29,3.1616690042075737,610,103,713
4067,Mechanical Engineering,2013,3.08,3.2,3.0979365079365078,643,113,756
4068,Mechanical Engineering,2014,3.11,3.1,3.108511904761905,715,125,840
4124,Mechanical Engineering,2014,3.0,3.1,3.019463087248322,240,58,298
4125,Mechanical Engineering,2013,2.9,2.8,2.8879377431906614,226,31,257
4126,Mechanical Engineering,2012,2.98,3.1,2.994941634241245,225,32,257
4127,Mechanical Engineering,2011,2.9,2.9,2.9,212,31,243
4128,Mechanical Engineering,2010,2.8,3.0,2.8206896551724134,182,21,203
4134,Mechanical Engineering,2014,2.78,2.87,2.786518691588785,397,31,428
4135,Mechanical Engineering,2013,2.67,3.1,2.6952410901467503,449,28,477
4136,Mechanical Engineering,2012,2.63,2.85,2.6445918367346937,366,26,392
4137,Mechanical Engineering,2011,2.74,2.6,2.7295702005730664,323,26,349
4138,Mechanical Engineering,2010,2.71,2.78,2.714953846153846,302,23,325
4232,Mechanical Engineering,2010,2.22,2.83,2.2762411347517735,128,13,141
4233,Mechanical Engineering,2011,2.02,2.01,2.0187719298245614,150,21,171
4234,Mechanical Engineering,2012,2.23,3.48,2.3816990291262137,181,25,206
4235,Mechanical Engineering,2013,2.08,2.26,2.108489208633094,234,44,278
4358,Mechanical Engineering,2015,3.04,2.98,3.0302826086956522,771,149,920
4577,Mechanical Engineering,2009,3.13,3.17,3.1359310344827587,988,172,1160
4578,Mechanical Engineering,2010,3.17,3.17,3.1700000000000004,989,176,1165
4579,Mechanical Engineering,2011,3.18,3.24,3.188585858585859,1018,170,1188
4580,Mechanical Engineering,2012,3.24,3.21,3.2352052401746723,962,183,1145
4581,Mechanical Engineering,2013,3.06,3.06,3.06,1027,189,1216
4582,Mechanical Engineering,2014,3.29,3.42,3.3105033557046974,753,141,894
4776,Mechanical Engineering,2015,3.0,3.22,3.0451655629139074,240,62,302
4884,Mechanical Engineering,2015,3.29,3.28,3.288377239199157,795,154,949
5220,Mechanical Engineering,2014,2.22,2.46,2.2538028169014086,305,50,355
5221,Mechanical Engineering,2015,2.13,2.6,2.195630630630631,382,62,444
5262,Mechanical Engineering,2015,2.93,3.05,2.94494071146245,443,63,506
1560,Computer Systems Engineering,2008,3.56,1.98,2.375,1,3,4
1561,Computer Systems Engineering,2009,2.99,2.74,2.9344444444444444,21,6,27
1562,Computer Systems Engineering,2010,3.05,2.88,3.0153061224489797,39,10,49
1563,Computer Systems Engineering,2011,2.95,2.99,2.95875,50,14,64
1564,Computer Systems Engineering,2012,2.93,3.09,2.9765822784810125,56,23,79
1959,Computer Systems Engineering,2007,2.99,3.01,2.9924827586206897,254,36,290
1960,Computer Systems Engineering,2008,3.01,3.14,3.0227272727272725,258,28,286
1961,Computer Systems Engineering,2009,3.07,3.18,3.08195652173913,246,30,276
1962,Computer Systems Engineering,2010,3.05,3.08,3.0532142857142857,275,33,308
1963,Computer Systems Engineering,2011,3.11,3.22,3.122758620689655,282,37,319
1964,Computer Systems Engineering,2012,3.12,3.06,3.114034090909091,317,35,352
1965,Computer Systems Engineering,2013,3.13,3.25,3.141937172774869,344,38,382
1306,Biosystems Engineering,2008,3.1,3.4,3.1890625,90,38,128
1307,Biosystems Engineering,2009,3.1,3.4,3.1972972972972973,100,48,148
1308,Biosystems Engineering,2010,3.1,3.3,3.1710059171597638,109,60,169
1309,Biosystems Engineering,2011,3.1,3.1,3.1000000000000005,109,75,184
4584,Engineering Technology,2009,2.66,2.84,2.689213709677419,831,161,992
4585,Engineering Technology,2010,2.71,2.78,2.7206365503080083,826,148,974
4586,Engineering Technology,2011,2.77,2.96,2.7937018255578097,863,123,986
4587,Engineering Technology,2012,2.79,2.86,2.7987830188679244,927,133,1060
4588,Engineering Technology,2013,2.62,2.49,2.603177816901409,989,147,1136
4589,Engineering Technology,2014,2.78,2.95,2.8037170731707315,882,143,1025
4883,Engineering Technology,2015,2.8,2.91,2.818560794044665,1005,204,1209
4642,Management Information Systems,2015,3.26494,3.45514,3.334210370370371,206,118,324
4713,Management Information Systems,2015,2.63,2.88,2.6844554455445544,158,44,202
4805,Management Information Systems,2011,2.58,2.44,2.5478688524590165,141,42,183
4806,Management Information Systems,2012,2.77,2.61,2.733044619422572,293,88,381
4808,Management Information Systems,2013,2.47,2.7,2.5157711442786073,322,80,402
4809,Management Information Systems,2014,2.54,2.4,2.512584856396867,308,75,383
